0,0,4,0,4,6,2,1,2,1,2,6,4,0,4,0,
0,0,4,0,1,1,3,3,3,3,3,1,1,0,4,0,
0,0,0,0,0,0,5,0,5,0,5,0,0,0,0,0,
0,0,0,0,0,0,0,5,0,5,0,0,0,0,0,0,
0,0,4,0,4,6,1,1,1,1,1,6,4,0,4,0,
