0,0,0,0,0,0,0,0,0,0,0,0,0,0,0,0,0,
3,0,1,3,3,3,3,3,3,3,3,3,3,3,1,0,3,
3,0,1,1,0,2,3,3,3,3,3,2,0,1,1,0,3,
3,0,1,0,1,0,2,3,3,3,2,0,1,2,1,0,3,
3,0,0,1,2,5,0,2,3,2,0,5,2,1,0,0,3,
3,0,0,0,1,2,5,0,3,0,5,2,1,0,0,0,3,
3,0,0,0,0,1,2,5,1,5,2,1,0,0,0,0,3,
3,0,0,0,0,0,1,2,5,2,1,0,0,0,0,0,3,
3,0,0,4,4,0,0,1,2,1,0,0,4,4,0,0,3,
3,0,0,0,0,0,0,0,1,0,0,0,0,0,0,0,3,
4,3,2,3,2,3,2,1,6,1,2,3,2,3,2,3,4

